111111111111111111111111111111111111111111111111111
100000000000000011111000000000100000000010000100001
10111111111111100000001111111000000000001010C101101
101000000000000011111111111111101111111110111101101
101011111111111010000000000000100000000C10100101101
101C00000000001010101111111110101111111110101101101
10111111111111101010000101001010111C000010101101101
101000000000000010111101P10010000011111010101101101
101101111111110110111101010011101010000010101101101
101001C000000000101C0001010000101010111110101101101
1010111111111111101111110100001010100000000001011C1
101000111111100C10000000010000101011111110111101111
101010000000001111111111110000101000010000000000011
1C1111111111111000000000001111101111011111111111011
1E1000000000000011111111100000001010000000000000001
111111111111111111111111111111111111111111111111111
