111111
1P10C1
111001
100001
1000E1
111111
