1111111
1P000C1
1111011
1E10001
1111111
