11111111
1P000001
11111011
1C0000E1
11111111
