11111111
1P00C0E1
10011111
1C0001C1
11111111
