1111111
1P000C1
1111011
1E00001
1111111
