11111111
1P00C0E1
10011101
1C0000C1
11111111
