111111111111111111111111111111111111111
10C00000000000000C00000000000000C000001
100000000000000C00000000000000000000001
100000000000000C00000000000000000000001
100000000000000C00000000000000000000001
100000000000000C00000000000000000000001
100000000000000C00000000000000000000001
100000000000000C00000000000000000000001
100000000000000C00000000000000000000001
100000000000000C00000000000000000000001
100000000000000C00000000000000000000001
100000000000000C00000000000000000000001
100000000000000C00000000000000000000001
100000000000000C00000000000000000000001
100000000000000C00000000000000000000001
100000000000000C00000000000000000000001
100000000000000C00000000000000000000001
100000000000000C00000000000000000000001
100000000000000C00000000000000000000001
100000000000000C00000000000000000000001
100000000000000C00000000000000000000001
100000000000000C00000000000000000000001
10P000C0000000000C000000000000000000001
111111111111111111111111111111111E11111
