1111111111
10C0000001
1000000001
1000000001
1000P00001
1000000001
1000000001
1000000001
1000000001
1111111111
