1111111111111111111111111
10C00000000000000C0C00001
100000000000000C000000001
100000000000000C000000001
100000000000000C000000001
100000000000000C000000001
100000000000000C000000001
100000000000000C000000001
100000000000000C000000001
100000000000000C000000001
100000000000000C000000001
100000000000000C000000001
100000000000000C000000001
100000000000000C000000001
100000000000000C000000001
100000000000000C000000001
100000000000000C000000001
100000000000000C000000001
10P000C0000000000C0000001
11111111111111111111E1111
