11111111111
10C00000001
10100000001
10100000001
10010000001
10001100001
10000011001
10000000001
10000000001
10P00000001
11111111111
