11111111111
10C00000001
10100000001
10100000001
10010000001
10001100001
10000011001
1000000C001
10000000001
10P0000000E
11111111111
