1111111111
1P00000001
1000000001
1000C0000
1000000001
10000000E1
1111111111
