1111111111
1P0000001
100000001
1000C0001
100000001
1000000E1
1111111111
