1111111111
1P00000001
1000000001
1000C11111
100001
1E0001
111111
