P0000000
00000000
000C0000
00000000
0000000E
