1111111111
1P00000001
1000000001
1000C00001
1000000001
1E000000E1
1111111111
