1111111111
1P00000001
1000000001
1000C00001
10000000P1
10000000E1
1111111111
